50,35
11111111111111111111111111111111111111111111111111
10000000000000000000000000000000000000000000000001
10000000000002000000200000000000000000000000000001
10000000000000000000000202002000200000000000000001
10000220200200220020200000020002200020000000000001
10000202000000020000200200000000000020200000000001
10000020000220000000000000020020000020000000000001
10000200020000000000000000000000000000000000000001
10000002000000000000000000000000000200012200000001
10000001000000000000000000000000000000000020000001
10000001000000000100000000000100000000000000000001
10000001000000000000000000000000000000010000000001
10000001000000000000000000000000000000000000000001
10000000000000000000000000000000000000010000000001
10000001000000000000000000000000000000000000000001
10000001000000000000000000000000000000010000000001
10000001000100000000000000000000000000000000000001
10000000100000000000000000000000000000000000000001
10000000000000000000000000000000000100010000000001
10000000100010000000000000000000000000000000000001
10000000010000010000000000000000010000100000000001
10000000001000000010000100010001000000100000000001
10000000000000000000000000000000000000000000000001
10000000000100000000000000000000000101000000000001
10000000000000111101000000000111101000000000000001
10000000000000000000001001010000000000000000000001
10000000000000000000000000000000000000000000000001
10000000000000000000000000000000000000000000000001
10000000000000000000000000000000000000000000000001
10000000000000000000000000000000000000000000000001
10000000000000000000000000000000000000000000000001
10000000000000000000000000000000000000000000000001
10000000000000000000000000000000000000000000000001
10000000000000000000000000000000000000000000000001
11111111111111111111111111111111111111111111111111
