50,35
11111111111111111111111111111111111111111111111111
10000000000000000000000000000000000000000000000001
10000000000000000000000000000000000000000000000001
10000000000000000000000000000000000000000000000001
10000000000000000000000000000000000000000000000001
10000000000010000100000000000000000000000000000001
10000000000000000000000000000000000000000000000001
10000000000002000000020000000000000000000000000001
10000000000000000000000000000020000020000000000001
10000000000000000000000000200002000000000000000001
10000000000000000000000000000000000000000000000001
10000000000000000000000000000000000000000000000001
10000000000000001000010000000000000000000000000001
10002100000020200000000000000100000000001000000001
10000000020000000000000000000000000000000000000001
10000000000000000000000201100000000000000000000001
10000002000010201001000000000000000000000000000001
10000000000000000000000000000000000200000000000001
10000000000001200000000000001000000000000000000001
10000000020000000000010000000000000000000000000001
10000000000000002002000000000000000000000000000001
10000000000020000000000000000000000000100000000001
10000000000000000000100000000000000000002000000001
20000000000000000200000000000000000000000000000001
10200000000000000000000000000010000000000000000001
10000000000000000000000100000000000000000000000001
10000000000000000000020000000000020000000000000001
10000000002000000000000000000000000000000000000001
10000000000000000000000000000002000000000000000001
10000000000000000000000002000000000000000000000001
10000000000000000000000000000000000000000000000001
10000000000000000000000000000000000000000000000001
10000000000000000000000000000000000000000000000001
10000000000000000000000000000000000000000000000001
11111111111111111111111111111111111111111111111111
